===================================================
*                                                 *
*                                                 *
*                                                 *
*             1                                   *
* p           *               *                   *
* **                        ****   *              *
*                          *                  *****
*     **      **     **                   *       *
*       *           **    ***      **    **  **   *
*          **      **                   ***     f *
++++++++++++++++++++++     ++++++++++++++++++++++++
+++++++++++++++++++++++++++++++++++++++++++++++++++
+++++++++++++++++++++++++++++++++++++++++++++++++++
